1;1;1;1;1;1;1;1;1;1;
1;3;3;3;3;4;1;3;9;1;
1;1;1;1;1;3;1;1;3;1;
1;3;3;7;1;P;3;3;3;1;
1;3;1;1;1;1;3;3;3;1;
1;3;3;3;1;14;1;3;3;1;
1;3;1;1;3;1;3;1;1;1;
1;3;1;5;3;1;3;1;8;1;
1;4;3;3;3;3;3;3;3;1;
1;1;1;1;1;1;1;1;1;1;
